flag_uso_correction_cnf	True
N_looks_stack_cnf	240
min_num_contributing_looks_cnf	486
roughness_seed_cnf	0.01
N_beams_sub_stack_cnf	480
epoch_seed_cnf	50
flag_azimuth_windowing_method_cnf	"none"
azimuth_window_width_cnf	64
flag_l1bs_file_cnf	False
thermal_noise_width_cnf	10
flag_postphase_azimuth_processing_cnf	False
right_avoided_samples_cal2_cnf	26
max_fitting_iterations_cnf	100
flag_antenna_weighting_cnf	False
width_avg_cal1_pulse_cnf	0
flag_remove_doppler_ambiguities_cnf	False
flag_azimuth_weighting_cnf	True
sigma_z_seed_cnf	0.025
parameter_fitting_flag_cnf	0
zero_freq_sample_number_lrm_cnf	128
zp_fact_range_cnf	2
flag_cal1_corrections_cnf	True
flag_doppler_range_correction_cnf	False
flag_avoid_zeros_in_multilooking_cnf	True
flag_cal2_correction_cnf	False
decimation_fact_range_l1bs_cnf	0
step_avg_cal1_pulse_cnf	0
num_lobes_int_cal1_cnf	2
flag_cal1_source_cnf	1
thermal_noise_flag_cnf	1
n_samples_fitting_rmc_cnf	120
thermal_noise_first_range_bin_cnf	9.5
k_fact_int_cal1_cnf	64
left_avoided_samples_cal2_cnf	24
zero_freq_sample_number_sar_cnf	128
flag_surface_weighting_cnf	True
num_samp_out_wfm_cnf	0
flag_window_delay_alignment_method_cnf	0
sigma_alt_surf_th_cnf	4.5
pu_seed_cnf	1
zero_pad_fact_cal1_cnf	256
flag_slant_range_correction_cnf	True
flag_cal1_power_cnf	0
n_samples_fitting_raw_cnf	256
